10109
1111111111
1111110111
1111111111
1111111111
1101111111
1101111111
1111111111
1111101111
0111111110
0111111111